11111111111
10001000001
10001100001
10000110001
11110111001
10000000001
11111111111