NO ./north.xpm
SO ./north.xpm
WE ./north.xpm
EA ./north.xpm

F 255,0,0
C 255,255,0



11111         11111
1000111111111110001
1000000000000000001
 10001111111110001
  10001     10001
   100011111100111111111111
    10000000000000000000001
     1000000011111111110001
      1111111          1001
                    1111001111111
                    1000000000001
             1111111001111100000011
            10000000000000100000001
            10000000000111110000001
            100011111001    1000001
            100010000111  111000001
            1N0010000001  100000001
            10001111100111110000001
            10000000000000000001111
            1000000000111111001
             111111111      11
