11111         11111
10001         10001
10001         10001
 10001       10001
  10001     10001
   1000111111001
    10000000001
     10000N001
      1111111