11111         11111
1000111111111110001
1000000000000000001
 10001111111110001
  10001     10001
   100011111100111111111111
    10000000000000000000001
     10000000111111111100N1
      1111111          1111