NO ./wall.xpm
SO ./wall.xpm
WE ./wall.xpm
EA ./wall.xpm

F 40, 40, 65
C 0, 0, 50



111111111111111111
100000000000000001
100000000000000001
100000000000000001
100000000000000001
100000000000000001
100000000000000001
100000000000000001
100000000000000001
10000000N000000001
100000000000000001
111111111111111111
