NO ./includes/textures/north.xpm
SO ./includes/textures/south.xpm
WE ./includes/textures/west.xpm
EA ./includes/textures/east.xpm

F 255, 255, 255
C 62, 52, 100
111111110111111111
100000000000000001
100000000000000001
100000000000000001
100000000000000001
100000000000000001
100000000000000001
100000000000000001
100000000000000001
10000000N0000000011
10000000000000000101
1111111111111111111111
