NO ./includes/textures/north.xpm
SO ./includes/textures/south.xpm
WE ./includes/textures/west.xpm
EA ./includes/textures/east.xpm

F 255, 255, 255
C 62, 52, 133

111111111111111111
100000000000000001
100000000000000001
100000000000000001
100000000000000001
100000000000000001
100000000000000001
100000000000000001
100000000000000001
10000000N000000001
100000000000000001
111111110111111111
