NO ./south.xpm
SO ./south.xpm
WE ./north.xpm
EA ./north.xpm

F 144,238,144
C 173,216,230

 
                                              111111111111111111
                                             10000000000000000001
                                             10000000000000000001
1 1 1 1 1 1 1 1 1 1 1 1 1 1 1 1 1 1 1 1 1 1 1 10000000000000000001
 111111111111111111111111111111111111111111111111111000011111111111111111111111111111111111111111111111111111111
10000010000000000000100000000000000100000000000000000000000010000000000000000000000000000000000000000000000000001
10000010000000000000100000000000000100000000000000000000000010000000000000000000000000000000000000000000000000001
10E00000000000000000000000000000000000000000000000000000000000000000000000000000000000000000000000000000000000001
10000010000000000000100000000000000100000000000000000000000010000000000000000000000000000000000000000000000000001
10000010000000000000100000000000000100000000000000000000000010000000000000000000000000000000000000000000000000001
 111111111111111111111111011111111111111111111111000111111111111111111111111111111111111111111111111111111111111
                        101             100000000000000000001
                        101             100000000000000000001
                        111             100000000000000000001
                                         1111111000001111111
                                               1000001111111
                                         1111111000001111111
                                               1000001111111
                                         1111111000001111111
                                               1000001111111
                                         1111111000001111111
                                               1000001111111
                                         1111111000001111111
                                               1000001111111
                                         1111111000001111111
                                               1000001111111
                                         1111111000001111111
                                               1000001111111
                                         1111111000001111111
                                               1000001111111
                                         1111111000001111111
                                               1000001111111
                                         1111111000001111111
                                               1000001111111
                                         1111111000001111111
                                               1000001111111
                                         1111111000001111111
                                               1000001111111
                                         1111111000001111111
                                               1000001111111
                                         1111111000001111111
                                               1000001111111
                                         1111111000001111111
                                               1000001111111
                                         1111111000001111111
                                               1000001111111
                                         1111111000001111111
                                               1000001111111
                                         1111111000001111111
                                               1000001111111
                                         1111111000001111111
                                               1000001111111
                                         1111111000001111111
                                               1000001111111
                                         1111111000001111111
                                               1000001111111
                                         1111111000001111111
                                         1111111000001111111
                                         1111111000001111111
                                         1111111000001111111
                                         1111111000001111111
                                         1111111000001111111
                                         1111111000001111111
                                         1111111000001111111
                                         1111111000001111111
                                         1111111000001111111
                                         1111111000001111111
                                         1111111000001111111
                                         1111111000001111111
                                         1111111000001111111
                                         1111111000001111111
                                         1111111000001111111
                                         1111111000001111111
                                         1111111000001111111
                                         1111111000001111111
                                         1111111000001111111
                                         1111111000001111111
                                         1111111000001111111
                                         1111111000001111111
                                         1111111000001111111
                                         1111111000001111111
                                         1111111000001111111
                                         1111111000001111111
                                         1111111000001111111
                                         1111111000001111111
                                         1111111000001111111
                                         1111111000001111111
                                         1111111000001111111
                                         1111111000001111111
                                         1111111000001111111
                                         1111111000001111111
                                         1111111000001111111
                                         1111111000001111111
                                         1111111000001111111
                                         1111111000001111111
                                         1111111000001111111
                                         1111111000001111111
                                         1111111000001111111
                                         1111111000001111111
                                         1111111000001111111
                                         1111111000001111111
                                         1111111000001111111
                                         1111111000001111111
                                         1111111000001111111
                                         1111111000001111111
                                         1111111000001111111
                                         1111111000001111111
                                         1111111000001111111
                                         1111111000001111111
                                         1111111000001111111
                                         1111111000001111111
                                         1111111000001111111
                                         1111111000001111111
                                         1111111000001111111
                                         1111111000001111111
                                         1111111000001111111
                                         1111111000001111111
                                         1111111000001111111
                                         1111111000001111111
                                         1111111000001111111
                                         1111111000001111111
                                         1111111000001111111
                                         1111111000001111111
                                         1111111000001111111
                                         1111111000001111111
                                               1000001
                                                11111