NO ./north.xpm
SO ./north.xpm
WE ./north.xpm
EA ./north.xpm

F 255,0,0
C 255,255,0

1111111111111111111111111111111111111111111111111111111
1000000000000010000000000000000000000000000000000000001
1000000000010010000000000000000000000000000000000000001
1000000000010010000000000000000000000000000000000000001
1000000000010010000000000000000000000000000000000000001
1000000000010010000000000000000000000000000000000000001
1000000000010010000000000000000000000000000000000000001
100000000001001000000000000000000000N000000000000000001
1000000000010010000000000000000000000000000000000000001
1000000000010010000000000000000000000000000000000000001
1000000000010010000000000000000000000000000000000000001
1000000000000000000000000000000000000000000000000000001
1000000000010010000000000000000000000000000000000000001
1000000000010010000000000000000000000000000000000000001
1111111111111111111111111111111111111111111111111111111
