NO ./includes/textures/north.xpm
SO ./includes/textures/north.xpm
WE ./includes/textures/south.xpm
EA ./includes/textures/south.xpm

F 40, 40, 65
C 0, 0, 50

1111111111111111111111111
1000000000110000000000001
10110N000111000000000001
100100000000000000000000111111111
111111111011000001110000000000001
100000000011000001110111100000111
1111011111111101110000001000001
1111011111111101110101001000001
1100000011010101110000001000001
100000000000000110000001000001
1000000000000000110101001000001
1100000111010101111101111000111
11110111 1110101 101111010001
11111111 1111111 111111111111