NO ./north.xpm
SO ./north.xpm
WE ./south.xpm
EA ./south.xpm

F 40, 40, 65
C 0, 0, 50

1111111111111111111111111
1000000000110000000000001
1011000001110000000000001
100100000000000000000000111111111
111111111011000001110000000000001
100000000011000001110111100000111
1111011111111101110000001000001
1111011111111101110101001000001
1100000011010101110000001000001
1000000000000000110000001000001
1000000000000000110101001000001
11000001110101011111011110N0111
11110111 1110101 101111010001
11111111 1111111 111111111111